Hints_0		{Для повышения выживаемости команды корабля нужны лекарства. Экономить не стоит. Имейте хотя бы по 3 единицы лекарств на 1 матроса}
Hints_1		{Личная способность "Профессиональный фехтовальщик" даёт существенную прибавку к набору опыта}
Hints_2		{Штрафы от дедвейта для скорости корабля начинаются с 70% загрузки, а для манёвренности с 50%}
Hints_3		{Товар "Оружие" на корабле необходим для абордажа (1 единица на 1 матроса), которое теряется при гибели матросов. Нехватка оружия перед боем значительно увеличит потери команды}
Hints_4		{Перечень доступных действий, вызываемых посредством команды "Мысли вслух", может отличаться в зависимости от текущего местонахождения игрока. Например в каюте, в порту и у стен города}
Hints_5		{Костюмы и кирасы можно носить одновременно, выбирая, что отображать в приоритете}
Hints_6		{Двойной клик по оружию или кораблю в Энциклопедии открывает окно для осмотра их 3D-модели в игре}
Hints_7		{Чтобы выбрать определённый вид боеприпаса для вашего текущего стрелкового оружия, его необходимо "взять" в меню предметов}
Hints_8		{Слоты экипировки в меню предметов кликабельны, если есть хотя бы один предмет, устанавливаемый в выбранный слот}
Hints_9		{Многие разделы внутриигрового интерфейса кликабельны (правой кнопкой мыши), что позволяет ознакомиться с дополнительной информацией}
Hints_10	{Чтобы изменять ход времени на суше, в море или на глобальной карте, необходимо использовать клавиши "+" и "-"}
Hints_11	{Автозакупка казначеем позволяет одной клавишей в меню торговли произвести все необходимые операции купли-продажи, но для этого необходимо произвести настройку закупок через диалог с казначеем или по "горячей" клавише}
Hints_12	{Заключение контракта с офицером - возможность через диалог с ним зафиксировать максимальную лояльность, а также дать ему полубессмертие. "Контрактный" офицер вместо смерти теряет сознание и получает ранение}
Hints_13	{При создании предметов в каюте учитываются ресурсы из сундуков}
Hints_14	{В папке с игрой есть опциональные моды}
Hints_15	{Звёздочка на портрете персонажа сигнализирует о нераспределённых очках способностей, как личных, так и корабельных}
Hints_16	{Характеристика персонажа "Сила" (P) влияет и на скорость восстановления энергии}
Hints_17	{ПГГ - такие же бравые корсары как и вы. С ними можно разным образом взаимодействовать. Каждого из них можно отключить при выборе персонажа в начале игры}
Hints_18	{При ремонте корабля чинятся и пушки, если они требуют ремонта. Также, при наличии пушек в трюме и свободных слотов в корабельной батарее, будет произведена автоматическая установка недостающих орудий}
Hints_19	{Победа над Летучим Голландцем даёт скрытый бонус к текущим ходовым характеристикам корабля ГГ. Этот бонус является личным и переходит от корабля к кораблю под управлением ГГ}
Hints_20	{Вы можете построить собственную колонию! Но сперва нужно выполнить небольшой квест архитектора, гуляющего по улицам Чарлстауна}
Hints_21	{Аптекарь может полностью вылечить раненого офицера}
Hints_22	{Риф скелета - очень опасное место по ночам. Без должной подготовки или абордажной команды туда лучше не соваться}
Hints_23	{В настройках управления также много всего интересного!}
Hints_24	{Настройки из главного меню игры не сбрасываются при создании нового профиля. Выбранные настройки переносятся в каждый новый созданный профиль}
Hints_25	{Чтобы получить флаг нации в корабельные способности ГГ, необходимо захватить корабль соответствующей нации}
Hints_26	{Для открытия быстрых переходов в городах враждебной нации необходимо развить личный навык скрытности до 50 очков (без учёта усиления от предметов), а также иметь торговую лицензию}
Hints_27	{После отплытия из Города Потерянных Кораблей на него можно вернуться через 10 дней}
Hints_28	{Найденный сундук можно взломать отмычками. Отмычки можно найти у лазутчиков или (иногда) купить у контрабандиста в таверне}
Hints_29	{Персонаж с характером "Авантюрист" с определённой вероятностью переживает смертельный удар, получая второй шанс и половинный запас здоровья}
Hints_30	{Карты из атласа позволяют пользоваться быстрым перемещением по соответствующему острову вместе с кораблём. Для этого необходимо воспользоваться атласом через меню предметов или по "горячей" клавише и кликнуть на нужную карту}
Hints_31	{Возможность захвата колоний (игроком или различными нациями) открывается после завершения одной из национальных квестовых линеек}
Hints_32	{Отскоки назад/влево/вправо помогают уклониться не только от ударов противника, но и от выстрелов}
Hints_33	{Если игрок не участвует в раунде турнира, то раунд можно пропустить при помощи клавиш "+" или "-"}
Hints_34	{Вы можете повторно погружаться на дно в ГПК посредством команды "Мысли вслух", находясь в каюте Механика на Сан Габриеле. Погружение возможно раз в двое суток. Ведекер при этом должен быть спасён из ГПК}
Hints_35	{Вы можете оставлять захваченные абордажем корабли дрейфовать. Это может пригодиться для дальнейших действий с ними через интерфейс обмена, который можно вызвать находясь борт к борту}
Hints_36	{Когда на корабле осталось совсем мало матросов, картечь против него становится бесполезна}
Hints_37	{Характеристика персонажа "Восприятие" также влияет на дальность видимости событий (шторм, эскадры, сражения, бочонки и т.д.) на Глобальной карте}
Hints_38	{У каждой нации есть свои уникальные вариации кораблей}
Hints_39	{Национальная линейка квестов за пиратов сочетается с прохождением любой национальной линейки. Перед взятием Панамы есть возможность начать и полностью пройти новую национальную линейку, а затем - продолжить пиратскую}
Hints_40	{Чтобы получить флаг нации в корабельные способности Главного Героя - необходимо захватить корабль соответствующей нации}
Hints_41	{При открытии ячейки у ростовщика можно перемещать в неё вещи из сундуков на корабле напрямую. Сундуки доступны в конце списка обмена после всех персонажей}
Hints_42	{Выкрики матросов на корабле во время боя привязаны к опции "Разговоры местных жителей"}
Hints_43	{Информацию о ПГГ, взятую в таверне, можно вызвать посредством нажатия клавиши "F10"}
Hints_44	{Рабов можно продавать на плантацию Барбадоса}
Hints_45	{Записи в судовом журнале про "Местонахождение подаренных предметов" и "Охотники за головами" всегда находятся в архиве}
Hints_46	{Если при использовании корабля "Пёс Войны" заговорить с Алексусом об улучшении корабля, то начнётся новый квест}
Hints_47	{Личная способность "Мародёрство" позволяет обыскивать всю локацию одной клавишей не только во время абордажа или штурма, но и в других локациях}
Hints_48	{Если взять Виспер абордажником во время выполнения квеста "Чёрные Паруса", она иногда будет давать короткие комментарии или обсуждать происходящее с ГГ}
Hints_49	{Существует возможность назначать офицеров на должности во вкладке меню предметов, не переключаясь на вкладку "Персонажи"}
Hints_50	{Если оставить в портовом управлении корабль вместе с командой, то навыки экипажа будут со временем деградировать}
Hints_51	{Опция для автопереключения на пиратский флаг после обнаружения контрабандным патрулем в "Мысли вслух" помогает избежать потери репутации, если заранее известно, что патруля не избежать}
Hints_52	{При выкидывании вещей у офицеров через инвентарь, они будут передаваться Главному Герою}
Hints_53	{Трубки с курительными смесями вызывают привыкание, что приводит к ухудшению навыков. В таком случае поможет только жрица любви}
Hints_54	{Через дипломата в пиратских тавернах можно решать многие вопросы, связанные с отношениями, в том числе и с ПГГ}
Hints_55	{Призовой фонд на турнирах динамически прогрессирует с течением времени}
Hints_56	{Торговля стала глубже и интереснее как никогда ранее в Корсарах}
Hints_57	{"Испанский Золотой Флот" в последнее время силён как никогда}
Hints_58	{Количество быстрых сохранений - 100 слотов}
Hints_59	{Матросы, гуляющие по городу, нанимаются и на корабли ваших компаньонов}
Hints_60	{Между взятием фрахтов должно пройти некоторое время}
Hints_61	{На Кюрасао и Мариго есть филиалы Голландской Вест-Индской Компании}
Hints_62	{Личную способность "Мародёрство" можно автоматически открыть и через выполнение условий: 20 захваченных или потопленных абордажем кораблей и 200 лично убитых противников}
Hints_63	{В складской книге также отображаются открытые у ростовщиков ячейки с личными вещами}
Hints_64	{Перемещение грузов, товаров, предметов, матросов и т.п. может производиться как стрелками на клавиатуре, так и кнопками мыши по стрелкам в интерфейсе. В обоих случаях можно дополнительно использовать клавишу Shift}
Hints_65	{Во всех городах колоний можно арендовать склад для товаров}
Hints_66	{Главному Герою с характером "Морской волк" или "Торговец" в начале новой игры выдаётся "Уникальный чертёж" корабля 6 класса}
Hints_67	{Личная способность "Заядлый контрабандист" помимо прочего позволяет полностью избегать как наземные, так и морские патрули, если ГГ не имеет компаньонов и командует кораблём 3 класса и ниже}
Hints_68	{ПГГ не всегда так просто убить. В определённых обстоятельствах они могут неожиданно вернуться за вами, да ещё и во главе эскадры кораблей}
Hints_69	{Вызвать компаньона в каюту и передать ему что-нибудь ценное - вернейший способ безвозвратно потерять все переданные ценности}
Hints_70	{Выполнение заданий корабела и заказ постройки кораблей у него будут улучшать навыки судостроителя. Это позволит использовать больше очков улучшения для кораблей, однако мастер Алексус Бермудский всё равно вне конкуренции}
Hints_71	{Ухудшившееся здоровье можно восстановить разными способами. Например, посетить бордель, обратиться к святому отцу, выпить Слёзы Ишь-Чель или просто отдыхать в съёмной комнате таверны}
Hints_72	{Капитул - особое здание, которое можно построить на Карибах в ходе одного из квестов. Капитул открывает возможность оставлять в нём офицеров на обучение}
Hints_73	{Мариго - самая крупная по своим размерам колония. Помимо прочего, в ней располагается один из филиалов Голландской Вест-Индской Компании, а также единственная в своём роде на Карибах аптека}
Hints_74	{Виспер - один из самых детально проработанных главных героев}
Hints_75	{Генри Морган утратил золотой ключ от своих сундуков. Может быть, он находится в каюте у какого-нибудь из свободных капитанов?}
Hints_76	{Слухи завсегдатаев таверны - крайне ценный источник информации. Но перво-наперво стоит поговорить с самим хозяином таверны}
Hints_77	{На Карибах действует Испанская Инквизиция}
Hints_78	{Для того, чтобы оскорбить и вызвать ПГГ на дуэль, нужен низкий уровень репутации}
Hints_79	{По цвету парусов корабля на глобальной карте можно определить пол ПГГ}
Hints_80	{Изменение навыков персонажа от смены комплектов происходит только после смены локации (кроме каюты)}
Hints_81	{В Карибском Море всё больше учащается количество необъяснимых вещей и явлений}
Hints_82	{Идеальный блок заблокирует вражеский "неотразимый удар", который пробил бы обычный блок. Но "идеальным" станет лишь блок, поставленный непосредственно в момент удара противника}
Hints_83	{Каждый уважающий себя корсар собирает полную коллекцию ацтекских тотемов. Но наличие двух одинаковых тотемов в инвентаре могут привести к поглощению одного другим при определённых обстоятельствах. Эффект не суммируется}
Hints_84	{Двуручное огнестрельное оружие может взять в руки любой офицер. Но принять участие в бою с ним в руках способны только соответствующие квестовые офицеры-мушкетёры и ПГГ}
Hints_85	{Существует возможность последовательно выполнить 2 национальных линейки квестов за одно прохождение. Сначала необходимо выполнить все задания для нации-государства. Далее приступить к прохождению пиратской линейки квестов}
Hints_86    {Вы можете настроить клавиши для быстрого переключения комплектов в настройках управления на суше}